....#########......................................
....#.......#......................................
....#.......#......................................
....#.......#......................................
....#.......#......................................
....#.......#......................................
....###########....................................
............#.#....................................
............#.#....................................
............#.#....................................
............#######................................
..............#...#................................
..............#...#.....###########.........#######
..............#...#.....#.........#.........#.....#
..............#...#.....#.........#.........#.....#
..............#...#.....#.........#.........#.....#
..........###########...#.........#.........#.....#
..........#...#...#.#...#.........#.........#.....#
..........#...###########.........#.........#.....#
..........#.......#.#.............#.........#.....#
......#############.#.............#...#############
......#...#.........#.............#...#.....#......
###########.........#...........#############......
#.....#.............#...........#.#...#............
#.....#.............#...........#.#######..........
#.....#.............#...........#.....#.#..........
#.....#.............#.....^############.#..........
#.....#.............#...........#.......#..........
#.....#.............#############.......#..........
#.....#.................................#..........
#######.................................#..........
........................................#..........
........................................#..........
........................................#..........
........................................#..........
........................................#..........
............................#############..........
............................#......................
............................#......................
............................#......................
............................#......................
............................#......................
............................#......................
............................#......................
............................#......................
............................#......................
............................#######................
..................................#................
..................................#................
..................................#................
..................................#................
..................................#................
..................................#................
..................................#................
..................................#................
..................................#................
..................................#................

R,12,L,6,R,12,
L,8,L,6,L,10,
R,12,L,6,R,12,
R,12,L,10,L,6,R,10,
L,8,L,6,L,10,
R,12,L,10,L,6,R,10,
L,8,L,6,L,10,
R,12,L,10,L,6,R,10,
R,12,L,6,R,12,
R,12,L,10,L,6,R,10

A,B,A,C,B,C,B,C,A,C
R,12,L,6,R,12
L,8,L,6,L,10
R,12,L,10,L,6,R,10
